XXXXXXXXXX
X      M X
X     T  X
X        X
X F O    X
X      T X
X        X
X   T    X
X      T X
XXXXXXXXXX 
